%%%%%%%%%%%
%    P ..%
%.%%%%%%%%
%     ..%
%%%%%%%%%%%